1111111111111111
11......X.....11
1..1.111111.1..1
1.11........11.1
1....1....1....1
1..111....111..1
1O............B1
1..11......11..1
1..1..1111..1..1
1..1...X....1..1
11...1....1...11
1111111111111111

MAP RULES
IF Tile size is 64 then 12x16
IF Tile size is 32 then 24x32
IF Tile size is 16 then 64x48

Walls = 1
Player 1 = O
Player 2 = B
Blobs = X
